1111111111111111111111111111111111
1000000000110000111100000000001001
1110011000000000001111000000001001
1100000000001110000011110000001001
10111110P00CC000E00000000011111001
1000000001110000000000000000000001
1000011111000000000011110000000001
1000000000000000000001111000000001
1000000111111000000001111000000001
1000000000001111000000111100000001
1000000000000000000000000000000001
1000111110001111000000000111100001
1000000000000001111000000000000001
1000011111000000000111000000000001
1000000001000011111100000111100001
1000001111000000000000000000000001
1111111111111111111111111111111111