11111111
1P0000E1
100001C1
11111111