111111111
1000011P1
10C001001
1E0000011
111111111